Indiana Snakes Identification
Kentucky Snakes Identification Guide: Species Profiles
Ohio Snakes Guide: Identifying All Species
Snakes in Arkansas: An Expert’s Guide on Each Species
Oklahoma Snakes Ultimate Species
Colorado Snakes: All Venomous
Massachusetts Snakes Species Guide: How to Identify
Illinois Snakes Species Catalog
Wisconsin Snakes Identification Guide
Louisiana Snakes Species Guide: Complete Catalog
South Carolina Snakes Identification Guide
California Snakes Species Identification Guide
Pennsylvania Snakes Identification Guide: All Species
Arizona Snakes Identification Guide: Species Info
Tennessee Snakes Species Guide
Michigan Snakes Species Guide: How to Identify Snakes
Virginia Snakes Identification: Species Catalog
Georgia Snakes Identification: Venomous
Missouri Snakes Identification Guide
Alabama Snakes Identification Guide: Species Background
Black Pastel Ball Python Care Sheet
Purple Passion Ball Python Care Guide
Lavender Albino Ball Python Care Guide
11 Ball Python Breeders
Scaleless Ball Python Care Sheet: Owner’s Guide to All Pet Needs
A Complete Texas Snakes State
Green Tree Python Care Sheet: Diet, Tank Setup,
Colombian Red Tail Boa Care Sheet: Pet
North Carolina Snakes Identification
Viper Boa Care Sheet: Background Info, Tank Setup, Diet,
Dumeril’s Boa Care Sheet: Crucial Info All Owners Should Know
Northern Rubber Boa Care Guide: Cost, Habitat, Diet,
Colombian Rainbow Boa: Care Sheet
Arabian Sand Boa Care Sheet: Diet, Habitat, FAQs,
Black Rainbow Boa: The Non
Rainbow Boa Care Sheet: Feeding, Housing,
Emerald Tree Boa Care Sheet: Needs
Orange Dream Ball Python Morph: Facts, Where to Buy,
Rainbow Python: Background, Genetics,
Red Tail Boa Constrictor: Diet, Habitat,
